1111111111111111-
1111111111111111-
1010011111111111-
4414441111111111-
1444140111111111-
1000040111111111-
1104441000111111-
1104000444444441-
1114444400111111-
1110000011111111