1111111110401111-
1111111110401111-
1111111110401111-
1111111110401111-
0000000000401111-
4444444444401111-
0000000000001111-
1111111111111111-
1111111111111111-
1111111111111111
