00000000000000000-
00000000000000000-
04444444444400000-
00000000000400000-
00000000000400000-
00000444444400000-
00000400000000000-
00000400000000000-
00000444444444440-
00000000000000000-
00000000000000000