000400000000101001000004000-
101410000011110100000014100-
000400001000000001000004000-
000444444444001044444444000-
000000013004100040030000010-
011110003004333340031001000-
000000003004010040030000001-
001004444444001044444440000-
000004000000001000000040010-
010104000100000000010040000-
000004000000001000000040000-
000104001000000000000040000-
110004444444444444444440000-
000001000000000000000000111-
000100010001000000100000010