00000000000000000-
00000000000000000-
00000000000000000-
04444444444400000-
00000004000400000-
00000004000400000-
00000004444444400-
00000000000000000-
00000000000000000-
00000000000000000-
00000000000000000