1111111343111111111-
1111111343111111111-
1111111343111111111-
1000100340001000000-
1000000340000111110-
1000000340000111110-
1000000340000000000-
1111111441111111111-
0000004440000000000-
0000044400000000000-
0000444000000000000-
0000400000000000000-
0000411111111111111-
0000444111111111111-
0000444411111111111-
1111144440111001110-
1111114440000000000-
1111111140000000000-
0004444440000000000-
0004111111111111111-
0004444111111111111-
0000144411111111111-
1111144441001100110-
1111114440000000000-
1111111140000000000-
0004444440000000000-
0004411111111111111-
0004444111111111111-
0004444411111111111-
1111144440000011000-
1111114440000011000-
1111111143011001100-
0000000044444400000-
1111111111444411111-
1111111111444411111-
1111111111444411111-
0000000440444400000-
0000000440444400000-
0000000440444400000-
0000000444444400000
