00000000000000001000200000000000000100000-
44400000000100000000200000010000200000000-
00300000002200000000000001000000000001000-
00445344344454444000000000000000010000000-
00000000002000004000000000100002200000000-
00000200000000004000000000000000000000000-
00000004443334434000010000000000110000000-
00002004000000000000000000000000000010200-
00000005020000000200000000011000000000200-
01000004000020000001000000000020000200000-
00000004000000200000000000001000001000000-
00000004444554434443444450001000000000200-
00100000010000000000000050000000000010000-
00002000000000000000000050000000100000000-
00000000000000110000000040001000000000000-
00000000100000000000000050000000044333444-
00000000000000000000000040100000040000000-
00000000000000001000000030000000040110000-
00001000200000000002000054344333440000000-
00000000002200000000000000000000000001000