11111111111111111111111111111111-
11111111111111111111111111111111-
11111111111111111111111111111111-
11111111111111111111111111111111-
11111111111111111111111111144444-
11111111111111111111111111144441-
11111111111111111111111111100341-
11111111111111111111111111100341-
11111111111111111111111111100341-
11111111111111111111111111100341-
11111111111111111111111111100341-
11111111111111111111111111100341-
11111111111111111111111111100341-
11111111111111111111111111100341-
11111111111111111111111111100341-
11111111111111111111111111100341-
11111111111111111111111111100341-
11111111111111111111111111100341-
11111111111111111111110011100341-
14333333333333333333333333333341-
14444444444444444444444444444441-
14300000000000000000000000000001-
14311111111111111111111111111111-
14311111111111111111111111111111-
14111111111111111111111111111111
